2 13 31
###############################
#p                            #
# # # # # # # # # # # # # # # #
#                             #
# # # # # # # # # # # # # # # #
#                             x
# # # # # # # # # # # # # # # #
#           4                 #
# # # # # # # # # # # # # # # #
#                             #
# # # # # # # # # # # # # # # #
#                 3           #
###############################