1 13 31
###############################
#p s                          #
# # # # # # # # # # # # # # # #
#b                            #
# # # # # # # # # # # # # # # #
#                             #
# # # # # # # # # # # # # # # #
#                             #
# # # # # # # # # # # # # # # #
#                             #
# # # # # # # # # # # # # # # #
#                 3           #
###############################